  NO ./textures/HEDGE.xpm     

  SO     ./textures/SLIME.xpm 

      
WE ./textures/SLUDGE.xpm    
EA ./textures/WARN.xpm   

  F 0,0,0   
  C 0, 30,0   
 
    11111111111 1111111      
   100000000000100000001      
  10000100000000010000101     
 1000000000000000000000001
100000000100000000N0000001
 1000000000001000000010001
  10000000000010000000001    
   11111111111 111111111