NO
SO
WE
EA

F 220,100,0
C 225,30,0


1111111111111111111111111
1111111111110000000000001
1011000001110000000000001
1001000000000000000000001
1111111110110000011100000111
10000000001100000111011111111111
11110111111111011100000010001
11110111111111011101010010001
11000000110101011100000010001
10000000000000001100000010001
10000N00000000001101010010001
11000001110101011111011110011
111101111110101101111010011
1111111111111111111111111