  C 0, 30    , 10  
NO textures/wolfenstein/grey_stone.xpm      
SO textures/wolfenstein/purple_stone.xpm
WE textures/wolfenstein/red_brick.xpm
EA textures/wolfenstein/wood.xpm
  F   10 , 10 ,10

 
    11111111111 1111111 
   1111111111111111111111      
  10000100000000010000101     
 1000000000000000000000001
1000000001000000000N00001
1111111111111111111111111111

 1000000000001000010010001
  10000000000010000000001    
   11111111111 111111111
