  NO ./textures/HEDGE.xpm  

   SO ./textures/SLIME.xpm
WE ./textures/SLUDGE.xpm
EA ./textures/WARN.xpm

  F 220,100,0
  C 225,30,0
 
    11111111111 111111111      
   100000000000100000001      
  1000010000000001000010111111      
 100000000000000000000000111
100000000100000000N000001
 1000000000001000000010001
  1000000000001000000000001    
   11111111111 11111111111