  NO ./textures/HEDGE.xpm  

   SO ./textures/SLIME.xpm
WE ./textures/SLUDGE.xpm
EA ./textures/WARN.xpm

  F 220,100,0
  C 225,30,0

  
    111111111111111111111      
   10000000000000000000001      
  1000010000000001000010001      
 1000000000000000000000001
100000000100000000N000001
 1000000000001000000010001
  1000000000000000000000001
   11111111111111111111111