NO
SO
WE
EA

F 220,100,0
C 225,30,0

    1111111111111111111111111         
   10000000000000000000001      
  1000000000000001000000001      
 1000000000000000000000001
1000000000000000000000001
 1000000000001000000000001
  1000000000000000000000001
   1000000000000000000000001
  1000000000000000000000001
 100000000000N000000000001
1111111111111111111111111